11111111111111111111111111111111111111111111111111111111111111111111111111111111111111111111111111111111111111111111111111111111
11111111111111111111111111111111111111111111111111111111111111111111111111111111111111111111111111111111111111111111111111111111
11111111111111111111111111111111111111111111111111111111111111111111111111111111111111111111111111111111111111111111111111111111
11111111111111111111111111111111111111111111111111111111111111111111111111111111111111111111111111111111111111111111111111111111
11111000000000000000000000000000000000000000000000011111111111111111111111111111111110000000000000000000000000000000000000000011
11111000000000000000000000000000000000000000000000001111111111111111111111111111111100000000000000000000000000000000000000000011
11111000000000000000000000000000000000000000000000000111111111111111111111111111111000000000000000000000000000000000000000000011
11111000000000000000000000000000000000000000000000000011111111111111111111111111110000000000000000000000000000000000000000000011
11111000000000000000000000000000000000000000000000000001111111111111111111111111100000000000000000000000000000000000000000000011
11111000000000000000000000000000000000000000000000000000111111111111111111111111000000000000000000000000000000000000000000000011
11111000000000000000000000000000000000000000000000000000011111111111111111111110000000000000000000000000000000000000000000000011
11111000000000000000000000000000000000000000000000000000001111111111111111111100000000000000000000000000000000000000000000000011
11111000000000000000000000000000000000000000000000000000000111111111111111111000000000000000000000000000000000000000000000000011
11111000000000000000000000000000000000000000000000000000000011111111111111110000000000000000000000000000000000000000000000000011
11111000000000000000000000000000000000000000000000000000000000000000000000000000000000000000000000000000000000000000000000000011
11111000000000000000000000000000000000000000000000000000000000000000000000000000000000000000000000000000000000000000000000000011
11111000000000000000000000000000000000000000000000000000000000000000000000000000000000000000000000000000000000000000000000000011
11111000000000000000000000000000000000000000000000000000000000000000000000000000000000000000000000000000000000000000000000000011
11111000000000000000011111111111111111111111111111100000000000000000000000000000000001111111111111111111111111100000000000000011
11111000000000000000111111111111111111111111111111110000000000000000000000000000000011111111111111111111111111110000000000000011
11111000000000000001111111111111111111111111111111111000000000000000000000000000000111111111111111111111111111111000000000000011
11111000000000000011111111111111111111111111111111111100000000000000000000000000001111111111111111111111111111111100000000000011
11111000000000000111111111111111111111111111111111111110000000000000000000000000011111111111111111111111111111111110000000000011
11111000000000001111111111111111111111111111111111111111000000000000000000000000111111111111111111111111111111111111000000000011
11111000000000001111111111111111111111111111111111111111100000000000000000000001111111111111111111111111111111111111000000000011
11111000000000001111111111111111111111111111111111111111110000000000000000000011111111111111111111111111111111111111000000000011
11111000000000001111111111111111111111111111111111111111111000000000000000000111111111111111111111111111111111111111000000000011
11111000000000001111111111111111111111111111111111111111111100000000000000001111111111111111111111111111111111111111000000000011
11111000000000001111111111111111111111111111111111111111111111111111111111111111111111111111111111111111111111111111000000000011
11111000000000001111111111111111111111111111111111111111111111111111111111111111111111111111111111111111111111111111000000000011
11111000000000001111111111111111111111111111111111111111111111111111111111111111111111111111111111111111111111111111000000000011
11111000000000001111111111111111111111111111111111111111111111111111111111111111111111111111111111111111111111111111000000000011
11111000000000001111111111111111111111111111111111111111111111111111111111111111111111111111111111111111111111111111000000000011
11111000000000001111111111111111111111111111111111111111111111111111111111111111111111111111111111111111111111111111000000000011
11111000000000001111111111111111111111111111111111111111111111111111111111111111111111111111111111111111111111111111000000000011
11111000000000001111111111111111111111111111111111111111111111111111111111111111111111111111111111111111111111111111000000000011
11111000000000001111111111111111111111111111111111111111111111111111111111111111111111111111111111111111111111111111000000000011
11111000000000001111111111111111111111111111111111111111111111111111111111111111111111111111111111111111111111111111000000000011
11111000000000001111111111111111111111111111111111111111111111111111111111111111111111111111111111111111111111111111000000000011
11111000000000001111111111111111111111111111111111111111111111111111111111111111111111111111111111111111111111111111000000000011
11111000000000001111111111111111111111111111111111111111111111111111111111111111111111111111111111111111111111111111000000000011
11111000000000001111111111111111111111111111111111111111111111111111111111111111111111111111111111111111111111111111000000000011
11111000000000001111111111111111111111111111111111111111111111111111111111111111111111111111111111111111111111111111000000000011
11111000000000001111111111111111111111111111111111111111111111111111111111111111111111111111111111111111111111111111000000000011
11111000000000001111111111111111111111111111111111111111111111111111111111111111111111111111111111111111111111111111000000000011
11111000000000001111111111111111111111111111111111111111111111111111111111111111111111111111111111111111111111111111000000000011
11111000000000001111111111111111111111111111111111111111111111111111111111111111111111111111111111111111111111111111000000000011
11111000000000001111111111111111111111111111111111111111111111111111111111111111111111111111111111111111111111111111000000000011
11111000000000001111111111111111111111111111111111111111111111111111111111111111111111111111111111111111111111111111000000000011
11111000000000001111111111111111111111111111111111111111111111111111111111111111111111111111111111111111111111111111000000000011
11111000000000001111111111111111111111111111111111111111111111111111111111111111111111111111111111111111111111111111000000000011
11111000000000001111111111111111111111111111111111111111111111111111111111111111111111111111111111111111111111111111000000000011
11111000000000001111111111111111111111111111111111111111111111111111111111111111111111111111111111111111111111111111000000000011
11111000000000001111111111111111111111111111111111111111111111111111111111111111111111111111111111111111111111111111000000000011
11111000000000001111111111111111111111111111111111111111111111111111111111111111111111111111111111111111111111111111000000000011
11111000000000001111111111111111111111111111111111111111111111111111111111111111111111111111111111111111111111111111000000000011
11111000000000001111111111111111111111111111111111111111111111111111111111111111111111111111111111111111111111111111000000000011
11111000000000001111111111111111111111111111111111111111111111111111111111111111111111111111111111111111111111111111000000000011
11111000000000001111111111111111111111111111111111111111111111111111111111111111111111111111111111111111111111111111000000000011
11111000000000001111111111111111111111111111111111111111111111111111111111111111111111111111111111111111111111111111000000000011
11111000000000001111111111111111111111111111111111111111111111111111111111111111111111111111111111111111111111111111000000000011
11111000000000001111111111111111111111111111111111111111111111111111111111111111111111111111111111111111111111111111000000000011
11111000000000001111111111111111111111111111111111111111111111111111111111111111111111111111111111111111111111111111000000000011
11111000000000001111111111111111111111111111111111111111111111111111111111111111111111111111111111111111111111111111000000000011
11111000000000001111111111111111111111111111111111111111111111111111111111111111111111111111111111111111111111111111000000000011
11111000000000001111111111111111111111111111111111111111111111111111111111111111111111111111111111111111111111111111000000000011
11111000000000001111111111111111111111111111111111111111111111111111111111111111111111111111111111111111111111111111000000000011
11111000000000001111111111111111111111111111111111111111111111111111111111111111111111111111111111111111111111111111000000000011
11111000000000001111111111111111111111111111111111111111111111111111111111111111111111111111111111111111111111111111000000000011
11111000000000001111111111111111111111111111111111111111111111111111111111111111111111111111111111111111111111111111000000000011
11111000000000001111111111111111111111111111111111111111111111111111111111111111111111111111111111111111111111111111000000000011
11111000000000001111111111111111111111111111111111111111111111111111111111111111111111111111111111111111111111111111000000000011
11111000000000001111111111111111111111111111111111111111111111111111111111111111111111111111111111111111111111111111000000000011
11111000000000001111111111111111111111111111111111111111111111111111111111111111111111111111111111111111111111111111000000000011
11111000000000001111111111111111111111111111111111111111111111111111111111111111111111111111111111111111111111111111000000000011
11111000000000001111111111111111111111111111111111111111111111111111111111111111111111111111111111111111111111111111000000000011
11111000000000001111111111111111111111111111111111111111111111111111111111111111111111111111111111111111111111111111000000000011
11111000000000001111111111111111111111111111111111111111111111111111111111111111111111111111111111111111111111111111000000000011
11111000000000001111111111111111111111111111111111111111111111111111111111111111111111111111111111111111111111111111000000000011
11111000000000001111111111111111111111111111111111111111111111111111111111111111111111111111111111111111111111111111000000000011
11111000000000001111111111111111111111111111111111111111111111111111111111111111111111111111111111111111111111111111000000000011
11111000000000001111111111111111111111111111111111111111111111111111111111111111111111111111111111111111111111111111000000000011
11111000000000001111111111111111111111111111111111111111111111111111111111111111111111111111111111111111111111111111000000000011
11111000000000001111111111111111111111111111111111111111111111111111111111111111111111111111111111111111111111111111000000000011
11111000000000000111111111111111111111111111111111111111111111111111111111111111111111111111111111111111111111111111000000000011
11111000000000000011111111111111111111111111111111111111111111111111111111111111111111111111111111111111111111111111000000000011
11111000000000000001111111111111111111111111111111111111111111111111111111111111111111111111111111111111111111111111000000000011
11111000000000000000111111111111111111111111111111111111111111111111111111111111111111111111111111111111111111111111000000000011
11111000000000000000011111111111111111111111111111111111111111111111111111111111111111111111111111111111111111111111000000000011
11111000000000000000000000000000000000000000000000000000000000000000000000000000011111111111111111111111111111111111000000000011
11111000000000000000000000000000000000000000000000000000000000000000000000000000011111111111111111111111111111111111000000000011
11111000000000000000000000000000000000000000000000000000000000000000000000000000011111111111111111111111111111111111000000000011
11111000000000000000000000000000000000000000000000000000000000000000000000000000011111111111111111111111111111111111000000000011
11111000000000000000000000000000000000000000000000000000000000000000000000000000011111111111111111111111111111111111000000000011
11111000000000000000000000000000000000000000000000000000000000000000000000000000011111111111111111111111111111111111000000000011
11111000000000000000000000000000000000000000000000000000000000000000000000000000011111111111111111111111111111111111000000000011
11111000000000000000000000000000000000000000000000000000000000000000000000000000011111111111111111111111111111111111000000000011
11111000000000000000000000000000000000000000000000000000000000000000000000000000011111111111111111111111111111111111000000000011
11111000000000000000000000000000000000000000000000000000000000000000000000000000011111111111111111111111111111111111000000000011
11111111111111111111111111111111111111111111111111111111111111110000000000000000011111111111111111111111111111111111000000000011
11111111111111111111111111111111111111111111111111111111111111111000000000000000011111111111111111111111111111111111000000000011
11111111111111111111111111111111111111111111111111111111111111111100000000000000011111111111111111111111111111111111000000000011
11111111111111111111111111111111111111111111111111111111111111111110000000000000011111111111111111111111111111111111000000000011
11111111111111111111111111111111111111111111111111111111111111111111000000000000011111111111111111111111111111111111000000000011
11111111111111111111111111111111111111111111111111111111111111111111100000000000011111111111111111111111111111111111000000000011
11111111111111111111111111111111111111111111111111111111111111111111100000000000011111111111111111111111111111111111000000000011
11111111111111111111111111111111111111111111111111111111111111111111100000000000011111111111111111111111111111111111000000000011
11111111111111111111111111111111111111111111111111111111111111111111100000000000001111111111111111111111111111111110000000000011
11111111111111111111111111111111111111111111111111111111111111111111100000000000000111111111111111111111111111111100000000000011
11111111111111111111111111111111111111111111111111111111111111111111100000000000000011111111111111111111111111111000000000000011
11111111111111111111111111111111111111111111111111111111111111111111100000000000000001111111111111111111111111110000000000000011
11111111111111111111111111111111111111111111111111111111111111111111100000000000000000111111111111111111111111100000000000000011
11111111111111111111111111111111111111111111111111111111111111111111100000000000000000000000000000000000000000000000000000000011
11111111111111111111111111111111111111111111111111111111111111111111100000000000000000000000000000000000000000000000000000000011
11111111111111111111111111111111111111111111111111111111111111111111100000000000000000000000000000000000000000000000000000000011
11111111111111111111111111111111111111111111111111111111111111111111100000000000000000000000000000000000000000000000000000000011
11111111111111111111111111111111111111111111111111111111111111111111100000000000000000000000000000000000000000000000000000000011
11111111111111111111111111111111111111111111111111111111111111111111100000000000000000000000000000000000000000000000000000000011
11111111111111111111111111111111111111111111111111111111111111111111100000000000000000000000000000000000000000000000000000000011
11111111111111111111111111111111111111111111111111111111111111111111100000000000000000000000000000000000000000000000000000000011
11111111111111111111111111111111111111111111111111111111111111111111100000000000000000000000000000000000000000000000000000000011
11111111111111111111111111111111111111111111111111111111111111111111100000000000000000000000000000000000000000000000000000000011
11111111111111111111111111111111111111111111111111111111111111111111100000000000000000000000000000000000000000000000000000000011
11111111111111111111111111111111111111111111111111111111111111111111100000000000000000000000000000000000000000000000000000000011
11111111111111111111111111111111111111111111111111111111111111111111100000000000000000000000000000000000000000000000000000000011
11111111111111111111111111111111111111111111111111111111111111111111100000000000000000000000000000000000000000000000000000000011
11111111111111111111111111111111111111111111111111111111111111111111111111111111111111111111111111111111111111111111111111111111
11111111111111111111111111111111111111111111111111111111111111111111111111111111111111111111111111111111111111111111111111111111
