33333333333333333333333333333333333333333333333333333333333333333333333333333333333333333333333333333333333333333333333333333333
33333333333333333333333333333333333333333333333333333333333333333333333333333333333333333333333333333333333333333333333333333333
33333333333333333333333333333333333333333333333333333333333333333333333333333333333333333333333333333333333333333333333333333333
33331111111111111111111111111111111111111111111111133333333333333333333333333333333331111111111111111111111111111111111111111113
33331000000000000000000000000000000000000000000000013333333333333333333333333333333310000000000000000000000000000000000000000013
33331000000000000000000000000000000000000000000000001333333333333333333333333333333100000000000000000000000000000000000000000013
33331000000000000000000000000000000000000000000000000133333333333333333333333333331000000000000000000000000000000000000000000013
33331000000000000000000000000000000000000000000000000013333333333333333333333333310000000000000000000000000000000000000000000013
33331000000000000000000000000000000000000000000000000001333333333333333333333333100000000000000000000000000000000000000000000013
33331000000000000000000000000000000000000000000000000000133333333333333333333331000000000000000000000000000000000000000000000013
33331000000000000000000000000000000000000000000000000000013333333333333333333310000000000000000000000000000000000000000000000013
33331000000000000000000000000000000000000000000000000000001333333333333333333100000000000000000000000000000000000000000000000013
33331000000000000000000000000000000000000000000000000000000133333333333333331000000000000000000000000000000000000000000000000013
33331000000000000000000000000000000000000000000000000000000011111111111111110000000000000000000000000000000000000000000000000013
33331000000000000000000000000000000000000000000000000000000000000000000000000000000000000000000000000000000000000000000000000013
33331000000000000000000000000000000000000000000000000000000000000000000000000000000000000000000000000000000000000000000000000013
33331000000000000000000000000000000000000000000000000000000000000000000000000000000000000000000000000000000000000000000000000013
33331000000000000000000000000000000000000000000000000000000000000000000000000000000000000000000000000000000000000000000000000013
33331000000000000000011111111111111111111111111111100000000000000000000000000000000001111111111111111111111111100000000000000013
33331000000000000000133333333333333333333333333333310000000000000000000000000000000013333333333333333333333333310000000000000013
33331000000000000001333333333333333333333333333333331000000000000000000000000000000133333333333333333333333333331000000000000013
33331000000000000013333333333333333333333333333333333100000000000000000000000000001333333333333333333333333333333100000000000013
33331000000000000133333333333333333333333333333333333310000000000000000000000000013333333333333333333333333333333310000000000013
33331000000000001333333333333333333333333333333333333331000000000000000000000000133333333333333333333333333333333331000000000013
33331000000000001333333333333333333333333333333333333333100000000000000000000001333333333333333333333333333333333331000000000013
33331000000000001333333333333333333333333333333333333333310000000000000000000013333333333333333333333333333333333331000000000013
33331000000000001333333333333333333333333333333333333333331000000000000000000133333333333333333333333333333333333331000000000013
33331000000000001333333333333333333333333333333333333333333100000000000000001333333333333333333333333333333333333331000000000013
33331000000000001333333333333333333333333333333333333333333311111111111111113333333333333333333333333333333333333331000000000013
33331000000000001333333333333333333333333333333333333333333333333333333333333333333333333333333333333333333333333331000000000013
33331000000000001333333333333333333333333333333333333333333333333333333333333333333333333333333333333333333333333331000000000013
33331000000000001333333333333333333333333333333333333333333333333333333333333333333333333333333333333333333333333331000000000013
33331000000000001333333333333333333333333333333333333333333333333333333333333333333333333333333333333333333333333331000000000013
33331000000000001333333333333333333333333333333333333333333333333333333333333333333333333333333333333333333333333333000000000033
33331000000000001333333333333333333333333333333333333333333333333333333333333333333333333333333333333333333333333333000000000033
33331000000000001333333333333333333333333333333333333333333333333333333333333333333333333333333333333333333333333333000000000033
33331000000000001333333333333333333333333333333333333333333333333333333333333333333333333333333333333333333333333333000000000033
33331000000000001333333333333333333333333333333333333333333333333333333333333333333333333333333333333333333333333333000000000033
33331000000000001333333333333333333333333333333333333333333333333333333333333333333333333333333333333333333333333333000000000033
33331000000000001333333333333333333333333333333333333333333333333333333333333333333333333333333333333333333333333333000000000033
33331000000000001333333333333333333333333333333333333333333333333333333333333333333333333333333333333333333333333333000000000033
33333000000000003333333333333333333333333333333333333333333333333333333333333333333333333333333333333333333333333333000000000033
33333000000000003333333333333333333333333333333333333333333333333333333333333333333333333333333333333333333333333333000000000033
33333000000000003333333333333333333333333333333333333333333333333333333333333333333333333333333333333333333333333333000000000033
33333000000000003333333333333333333333333333333333333333333333333333333333333333333333333333333333333333333333333333000000000033
33333000000000003333333333333333333333333333333333333333333333333333333333333333333333333333333333333333333333333333000000000033
33333000000000003333333333333333333333333333333333333333333333333333333333333333333333333333333333333333333333333333000000000033
33333000000000003333333333333333333333333333333333333333333333333333333333333333333333333333333333333333333333333333000000000033
33333000000000003333333333333333333333333333333333333333333333333333333333333333333333333333333333333333333333333333000000000033
33333000000000003333333333333333333333333333333333333333333333333333333333333333333333333333333333333333333333333333000000000033
33333000000000003333333333333333333333333333333333333333333333333333333333333333333333333333333333333333333333333333000000000033
33333000000000003333333333333333333333333333333333333333333333333333333333333333333333333333333333333333333333333333000000000033
33333000000000003333333333333333333333333333333333333333333333333333333333333333333333333333333333333333333333333333000000000033
33333000000000003333333333333333333333333333333333333333333333333333333333333333333333333333333333333333333333333333000000000033
33333000000000003333333333333333333333333333333333333333333333333333333333333333333333333333333333333333333333333333000000000033
33333000000000003333333333333333333333333333333333333333333333333333333333333333333333333333333333333333333333333333000000000033
33333000000000003333333333333333333333333333333333333333333333333333333333333333333333333333333333333333333333333333000000000033
33333000000000003333333333333333333333333333333333333333333333333333333333333333333333333333333333333333333333333333000000000033
33333000000000003333333333333333333333333333333333333333333333333333333333333333333333333333333333333333333333333333000000000033
33333000000000003333333333333333333333333333333333333333333333333333333333333333333333333333333333333333333333333333000000000033
33333000000000003333333333333333333333333333333333333333333333333333333333333333333333333333333333333333333333333333000000000033
33333000000000003333333333333333333333333333333333333333333333333333333333333333333333333333333333333333333333333333000000000033
33333000000000003333333333333333333333333333333333333333333333333333333333333333333333333333333333333333333333333333000000000033
33333000000000003333333333333333333333333333333333333333333333333333333333333333333333333333333333333333333333333333000000000033
33333000000000003333333333333333333333333333333333333333333333333333333333333333333333333333333333333333333333333333000000000033
33333000000000003333333333333333333333333333333333333333333333333333333333333333333333333333333333333333333333333333000000000033
33333000000000003333333333333333333333333333333333333333333333333333333333333333333333333333333333333333333333333333000000000033
33333000000000003333333333333333333333333333333333333333333333333333333333333333333333333333333333333333333333333333000000000033
33333000000000003333333333333333333333333333333333333333333333333333333333333333333333333333333333333333333333333333000000000033
33333000000000003333333333333333333333333333333333333333333333333333333333333333333333333333333333333333333333333333000000000033
33333000000000003333333333333333333333333333333333333333333333333333333333333333333333333333333333333333333333333331000000000013
33333000000000003333333333333333333333333333333333333333333333333333333333333333333333333333333333333333333333333331000000000013
33333000000000003333333333333333333333333333333333333333333333333333333333333333333333333333333333333333333333333331000000000013
33333000000000003333333333333333333333333333333333333333333333333333333333333333333333333333333333333333333333333333000000000033
33333000000000003333333333333333333333333333333333333333333333333333333333333333333333333333333333333333333333333333000000000033
33333000000000003333333333333333333333333333333333333333333333333333333333333333333333333333333333333333333333333333000000000033
33333000000000003333333333333333333333333333333333333333333333333333333333333333333333333333333333333333333333333333000000000033
33333000000000003333333333333333333333333333333333333333333333333333333333333333333333333333333333333333333333333333000000000033
33333000000000003333333333333333333333333333333333333333333333333333333333333333333333333333333333333333333333333333000000000033
33331000000000001333333333333333333333333333333333333333333333333333333333333333333333333333333333333333333333333333000000000033
33331000000000001333333333333333333333333333333333333333333333333333333333333333333333333333333333333333333333333333000000000033
33331000000000001333333333333333333333333333333333333333333333333333333333333333333333333333333333333333333333333333000000000033
33331000000000001333333333333333333333333333333333333333333333333333333333333333333333333333333333333333333333333333000000000033
33331000000000001333333333333333333333333333333333333333333333333333333333333333333333333333333333333333333333333333000000000033
33331000000000000133333333333333333333333333333333333333333333333333333333333333333333333333333333333333333333333333000000000033
33331000000000000013333333333333333333333333333333333333333333333333333333333333333333333333333333333333333333333333000000000033
33331000000000000001333333333333333333333333333333333333333333333333333333333333333333333333333333333333333333333333000000000033
33331000000000000000133333333333333333333333333333333333333333333333333333333333333333333333333333333333333333333330000000000033
33331000000000000000011111111111111133333333333333333333333111111111111111333333333333333333333333333333333333333300000000000033
33331000000000000000000000000000000000000000000000000000000000000000000000000000033333333000000000000000000000000000000000000033
33331000000000000000000000000000000000000000000000000000000000000000000000000000033333333000000000000000000000000000000000000033
33331000000000000000000000000000000000000000000000000000000000000000000000000000033333333000000000000000000000000000000000000033
33331000000000000000000000000000000000000000000000000000000000000000000000000000033333333333333333333333333333333331000000000013
33331000000000000000000000000000000000000000000000000000000000000000000000000000033333333333333333333333333333333331000000000013
33331000000000000000000000000000000000000000000000000000000000000000000000000000013333333333333333333333333333333331000000000013
33331000000000000000000000000000000000000000000000000000000000000000000000000000013333333333333333333333333333333331000000000013
33331000000000000000000000000000000000000000000000000000000000000000000000000000013333333333333333333333333333333331000000000013
33331000000000000000000000000000000000000000000000000000000000000000000000000000013333333333333333333333333333333331000000000013
33331000000000000000000000000000000000000000000000000000000000000000000000000000013333333333333333333333333333333331000000000013
33331111111111111111111111111111111133333333333333333333333111110000000000000000013333333333333333333333333333333331000000000013
33333333333333333333333333333333333333333333333333333333333333331000000000000000013333333333333333333333333333333331000000000013
33333333333333333333333333333333333333333333333333333333333333333100000000000000013333333333333333333333333333333331000000000013
33333333333333333333333333333333333333333333333333333333333333333310000000000000013333333333333333333333333333333331000000000013
33333333333333333333333333333333333333333333333333333333333333333331000000000000013333333333333333333333333333333331000000000013
33333333333333333333333333333333333333333333333333333333333333333333100000000000013333333333333333333333333333333331000000000013
33333333333333333333333333333333333333333333333333333333333333333333100000000000013333333333333333333333333333333331000000000013
33333333333333333333333333333333333333333333333333333333333333333333100000000000013333333333333333333333333333333331000000000013
33333333333333333333333333333333333333333333333333333333333333333333100000000000001333333333333333333333333333333310000000000013
33333333333333333333333333333333333333333333333333333333333333333333100000000000000133333333333333333333333333333100000000000013
33333333333333333333333333333333333333333333333333333333333333333333100000000000000013333333333333333333333333331000000000000013
33333333333333333333333333333333333333333333333333333333333333333333100000000000000001333333333333333333333333310000000000000013
33333333333333333333333333333333333333333333333333333333333333333333100000000000000000111111111111111111111111100000000000000013
33333333333333333333333333333333333333333333333333333333333333333333100000000000000000000000000000000000000000000000000000000013
33333333333333333333333333333333333333333333333333333333333333333333100000000000000000000000000000000000000000000000000000000013
33333333333333333333333333333333333333333333333333333333333333333333100000000000000000000000000000000000000000000000000000000013
33333333333333333333333333333333333333333333333333333333333333333333100000000000000000000000000000000000000000000000000000000013
33333333333333333333333333333333333333333333333333333333333333333333100000000000000000000000000000000000000000000000000000000013
33333333333333333333333333333333333333333333333333333333333333333333100000000000000000000000000000000000000000000000000000000013
33333333333333333333333333333333333333333333333333333333333333333333100000000000000000000000000000000000000000000000000000000013
33333333333333333333333333333333333333333333333333333333333333333333100000000000000000000000000000000000000000000000000000000013
33333333333333333333333333333333333333333333333333333333333333333333100000000000000000000000000000000000000000000000000000000013
33333333333333333333333333333333333333333333333333333333333333333333100000000000000000000000000000000000000000000000000000000013
33333333333333333333333333333333333333333333333333333333333333333333100000000000000000000000000000000000000000000000000000000013
33333333333333333333333333333333333333333333333333333333333333333333100000000000000000000000000000000000000000000000000000000013
33333333333333333333333333333333333333333333333333333333333333333333100000000000000000000000000000000000000000000000000000000013
33333333333333333333333333333333333333333333333333333333333333333333100000000000000000000000000000000000000000000000000000000013
33333333333333333333333333333333333333333333333333333333333333333333111111111111111111111111111111111111111111111111111111111113
33333333333333333333333333333333333333333333333333333333333333333333333333333333333333333333333333333333333333333333333333333333
