11111111111111111111111111111111111111111111111111122222222222222222222222211111111111111111111111111111111111111111111111111111
12222222222222222222222222222222222222222222222221122222220022222222022222212222222222222222222222222222222222222222222222222221
12222222222222222222222222222222222222222222222221122222203330002220332222212222222222222222222222222222222222222222222222222221
12222222222222222222222222222222222222222222222221122222233333333003332222212222222222222222222222222222222222222222222222222221
12222222222222222222222222222222222222222222222221122222033333333333333222212222222222222222222200002222222222222222222222222221
12222222222222222222222222222222222222222222222221122222333333333333333222212222222222222222200000000000222222222222222222222221
12222222222222222222222222222222222222222222222222112223333333333333333322212222222222222222000000000000000022222222222222222221
12222222222222222222222222222222222222222222222222211203333333333333333332212222222222222220000000000000000000222222222222222221
12222222222222222222222222222222222222222222222222221111111111111111111111112222220002220000000000000000000000002222222222222221
12222222222222222222222222222222222222200022000022222000000000000000000000222200000000000000000000000000000000000222222222222221
12222222222222222222222222222222222220000000000000000000000000000000000000000000000000000000000000000000000000000022222222222221
12222222222222222222222222222222222000000000000000000000000000000000000000000000000000000000000000000000000000000002222222222221
12222222222222222222222222222222200000000000000000000000000000000000000000000000000000000000000000000000000000000000222222222221
12222222222222222222222222222220000000000000000000000000000000000000000000000000000000000000000000000000000000000000222222222221
12222222222222222222222222222000000000000000000000000000000000000000000000000000000000000000000000000000000000000000022222222221
12222222222222222222222222220000000000000000000000000000000000000000000000000000000000000002222220000000000000000000022222222221
12222222222222222222222222200000000000000000000000222000000000000000000000200000000002222222222222200000000000000000002222222221
12222222222222222222222222000000000000000000000022221111111111111111111111112002222222222222222222222000000000000000002222222221
12222222222222222222222200000000000000000000002222211022222222222222222222212222222222222222222222222220000000000000002222222221
12222222222222222222222000000000000000220000222222112222222222222222222222212222222222222222222222222222000000000000000222222221
12222222222222222222220000000000000022222222222221120222222222222222222222212222222222222222222222222222200000000000000222222221
12222222222222222222200000000000002222111111111111220222222222222222222222212222222222222222222222222222220000000000000222222221
12222222222222222222000000000000222221111111111111222222222222222222222222211111111111111122222222222222222000000000000022222221
12222222222222222220000000000002222211122222222222222222222222222222222222211111111111111122222222222222222000000000000022222221
12222222222222222220000000000022222111222222222220222222222222222222222222222222222222221122222222222222222200000000000002222221
12222222222222222200000000000222221112222222222222222222222222222222222222222222222222221122222222222222222200000000000002222221
12222222222222222000000000002222211122222222222222222222222222222222222200222222222222221122222222222222222200000000000000222221
12222222222222220000000000002222111222222222202222222222222222222222222222222222222222221122222222222222222220000000000000222221
12222222222222200000000000022221112222222222222222222222222222222222222222222222222222221122222222222222222220000000000000022221
12222222222222000000000000022211122222200002222222222222222222222222222222222222222222221122222222222222222220000000000000022221
12222222222220000000000000222211200022222222222222222222222222222222222222222222222222221122222222222222222220000000000000222221
12222222222200000000000000222211222222222222222222222222222222222222222222222222222222221122222222222222222222000000000000222221
12222222222000000000000002222211222222222222222222222222222222222222222222222222222222221122222222222222222220000000000002222221
12222222222000000000000022222011222222222222222222222222222222222222222222222002222222221122222222222222222220000000000000222221
12222222222000000000000222220211222222222222222222222222222222222222222222222222222222221122222222222222222220000000000000222221
12222222220000000000002222002211222222222222222222222222222222222222222222222222222222221122222222222222222220000000000000222221
12222222220000000000022220222211222222222222222222222222222222222222222222222222222222221122222222222222222200000000000002222221
12222222200000000000222220222112222222222222222222222222222222222222202222222222222222221122222222222222222000000000000002222221
12222222200000000000222222222112222222222222222222222222222222222222222222222222222222221122222222222222222000000000000000222221
12222222200000000022222222022211222222222222222222200000000022222222222222222222222222221122222222222222220000000000000000222221
12222222200000000222222222222211222222222222222200000000000000002222222222222222222222221122222222222222220000000000000002222221
12222222220000000222222222222211222222222222220000000000000000000022222222222222222222221122222222222222200000000000000022222221
12222222220000000022222222222211222222222222000000000000000000000000222222222222222222221122222222222220000000000000000022222221
12222222220000000022222222222211222222222200000000000000000000000000022222222222222222221122222222222000000000000000000222222221
12222222220000000022222222222211222222222000000000000000000000000000002222222222222222221122222222220000000000000000000222222221
12222222222000000022222222222211222222220000000000000000000000000000000222222222222222221122222222200000000000000000002222222221
12222222222000000002222222222211222222200000000000000000000000000000000222222222222222221122222222000000000000000000022222222221
12222222222000000002222222222211222222200000000000000000000000000000000022222222222222221122222220000000000000000000222222222221
12222222220000000002222222202211222222000000000000000000000000000000000022222222222222221122222200000000000000000002222222222221
12222222220000000000222222202211222222000000000000000000000000000000000002222222222222221122222200000000000000000022222222222221
12222222200000000000222222222211222222000000000000000000000000000000000000222222222222221122222000000000000000002222222222222221
12222222200000000000222222222011222222000000000000000000000000000000000000022222222222221122222000000000000000222222222222222221
12222222200000000002222222222211222220000000000000000002222000000000000000002222222222221122220000000000000022222222222222222221
12222222200000000002222222222211222220000000000000000222222220000000000000000222222222221122220000000000000222222222222222222221
12222222200000000002222222222211222220000000000000002222222222200000000000000222222222221122220000000000002222222222222222222221
12222222200000000002222222222211222220000000000000022211222222222000000000000022222222221122220000000000022222222222222222222221
12222222200000000000222222222211222220000000000000022211122222222220000000000022222222221122200000000000222222222222222222222221
12222222220000000000222222222211222220000000000000022221112222222222000000000002222222221122200000000002222222222222222222222221
12222222220000000000222222222211222220000000000000022222111222222222200000000002222222221122200000000002222222222222222222222221
12222222220000000000222222222211222220000000000000022222211122222222220000000000222222221122200000000022222222222222222222222221
12222222220000000000022222222211222222000000000000002222221112222222222000000000222222221122200000000022222222222222222222222221
12222222222000000000022222222211222222000000000000002222222111222222222200000000022222221122200000000021111111122222222111111111
12222222222000000000022222222211222222000000000000002222222211122222222220000000022222221122200000000021111111122222222111111111
12222222222000000000002222222211222222200000000000000222222221112222222220000000002222221122200000000022222222222222222222222221
12222222222000000000002222222211222222200000000000000022222222111222222222000000002222221122200000000002222222222222222222222221
12222222222000000000000222222211222222220000000000000002222222211122222222000000000222221122220000000000222222222222222222222221
12222222220000000000000222222211222222220000000000000000222222221112222222200000000222221122220000000000022222222222222222222221
12222222220000000000000222222211222222222000000000000000022222222111222222200000000022221122220000000000022222222222222222222221
12222222220000000000002222222211222222222200000000000000002222222211122222200000000022221122222000000000002222222222222222222221
12222222222000000000002222222211222222222220000000000000002222222221112222220000000022221122222000000000002222222222222222222221
12222222222000000000002222222211222222222222200000000000000222222222111222220000000002221122222200000000000222222222222222222221
12222222220000000000002222222211222222222222222000000000000222222222211122220000000002221122222200000000000022222222222222222221
12222222220000000000002222222211222222222222222200000000000022222222221122220000000002221112222220000000000002222222222222222221
12222222200000000000002222222211222222222222222220000000000022222222221122222000000002222111222222000000000000022222222222222221
12222222200000000000000222222211222222222222222222000000000002222222221122222000000000222211222222200000000000000222222222222221
12222222200000000000000222222211222222222222222222200000000002222222221122222000000000222211222222200000000000000002222222222221
12222222220000000000000222222211222222222222222222200000000000222222221122222000000000222211222222220000000000000000222222222221
12222222220000000000002222222211222222222222222222220000000000222222221122222200000000222211222222220000000000000000022222222221
12222222200000000000002222222211222222222222222222220000000000022222221122222200000000022211222222220000000000000000002222222221
12222222200000000000000222222211222222222222222222222000000000022222221122222200000000022211222222222000000000000000002222222221
12222222200000000000000222222211222222222222222222222000000000022222221122222200000000022211122222222200000000000000000222222221
12222222200000000000000222222211222222222222222222222200000000002222221122222220000000022221112222222222000000000000000002222221
12222222220000000000000222222211222222222222222222222200000000002222221122222220000000002222111222222222220000000000000000222221
12222222220000000000000222222211222222222222222222222200000000002222221122222220000000002222211122222222222000000000000000222221
12222222220000000000002222222211222222222222222222222220000000002222221122222220000000002222221112222222222200000000000000222221
12222222200000000000002222222211122222222222222222222220000000000222221122222222000000002222222111222222222220000000000000222221
12222222200000000000002222222221112222222222222222222220000000000222221122222222000000000222222211122222222220000000000000222221
12222222200000000000002222222222111222222222222222222220000000000222221122222222000000000222222221112222222222000000000000222221
12222222200000000000000222222222211122222222222222222222000000000222221122222222000000000222222222111222222222000000000000222221
12222222200000000000000222222222221112222222222222222222000000000022221122222222000000000022222222211122222222000000000000222221
12222222200000000000000222222222222111222222222222222222000000000022221122222222000000000022222222221112222220000000000000022221
12222222200000000000000222222222222211122222222222222222000000000022221122222222000000000002222222222111222220000000000000022221
12222222220000000000000022222222222221112222222222222222000000000022221122222222200000000002222222222211122220000000000000022221
12222222220000000000000022222222222222111222222222222222000000000002221122222222200000000000222222222221112220000000000000022221
12222222220000000000000022222222222222211122222222222222000000000002221122222222220000000000022222222222112222000000000000022221
12222222220000000000000002222222222222221112222222222220000000000002221122222222220000000000002222222222112222000000000000022221
12222222222000000000000000222222222222222111222222222220000000000002221122222222220000000000000222222222112222000000000000022221
12222222222000000000000000022222222222222211122222222200000000000000221122222222222000000000000022222222112220000000000000022221
12222222222000000000000000000222222222222221112222222200000000000000221122222222222000000000000002222222222220000000000000002221
12222222222000000000000000000002222222222222111222222000000000000000221122222222222000000000000000222222222200000000000000002221
12222222220000000000000000000000022222222222211122222000000000000000221122222222222000000000000000002222222000000000000000002221
12222222220000000000000000000000000002222222221122220000000000000000221122222222222200000000000000000022000000000000000000002221
12222222220000000000000000000000000000000222222222200000000000000000221122222222222200000000000000000000000000000000000000002221
12222222220000000000000000000000000000000000022000000000000000000000221122222222222200000000000000000000000000000000000000002221
12222222220000000000000000000000000000000000000000000000000000000000221122222222222200000000000000000000000000000000000000002221
12222222220000000000000000000000000000000000000000000000000000000000221122222222222220000000000000000000000000000000000000002221
12222222222000000000000000000000000000000000000000000000000000000000221122222222222220000000000000000000000000000000000000002221
12222222222000000000000000000000000000000000000000000000000000000000221122222222222220000000000000000000000000000000000000002221
12222222222200000000000000000000000000000000000000000000000000000002221122222222222222000000000000000000000000000000000000002221
12222222222200000000000000000000000000000000000000000000000000000002221122222222222222200000000000000000000000000000000000002221
12222222222220000000000000000000000000000000000000000000000000000002221122222222222222220000000000000000000000000000000000022221
12222222222220000000000000000000000000000000000000000000000000000002221122222222222222220000000000000000000000000000000000022221
12222222222220000000000000000000000000000000000000000000000000000022221122222222222222222000000000000000000000000000000000022221
12222222222220000000000000000000000000000000000000000000000000000022221122222222222222222000000000000000000000000000000000222221
12222222222222000000000000000000000000000000000000000000000000000022221122222222222222222200000000000000000000000000000000222221
12222222222222200000000000000000000000000000000000000000000000000222221122222222222222222200000000000000000000000000000002222221
12222222222222200000000000000000000000000000000000000000000000000222221122222222222222222220000000000000000000000000000222222221
12222222222222220000000000000000000000000000000000000000000000002222221122222222222222222220000000000000000000000000002222222221
12222222222222220000000000000000000000000000000000000000000000002222221122222222222222222222000000000000000000000002222222222221
12222222222222222000000000000000000000000000000000000000000000022222221122222222222222222222200000000000000002222222222222222221
12222222222222222000000000000000000000000000000000000000000000222222221122222222222222222222220000000000000222222222222222222221
12222222222222222222000000000000000000000000000000000000000222222222221122222222222222222222222200000002222222222222222222222221
12222222222222222222200000000000000000000000000000000002222222222222221122222222222222222222222222222222222222222222222222222221
12222222222222222222222220000000000022000000000000022222222222222222221122222222222222222222222222222222222222222222222222222221
12222222222222222222222222222222222222222222222222222222222222222222221122222222222222222222222222222222222222222222222222222221
12222222222222222222222222222222222222222222222222222222222222222222221122222222222222222222222222222222222222222222222222222221
12222222222222222222222222222222222222222222222222222222222222222222221122222222222222222222222222222222222222222222222222222221
11111111111111111111111111111111111111111111111111111111111111111111111111111111111111111111111111111111111111111111111111111111
