11111111111111111111111111111111111111111111111111111111111111111111111111111111111111111111100000000000000000000000000000000000
12222222222222222222222222222222222222222222222222222222222222222222222222222222222222222222100000000000000000000000000000000000
12222222222222222222222222222222222222222222222222222222222222222222222222222222222222222222100000000000000000000000000000000000
12222222222222222222222222222222222222222222222222222222222222222222222222222222222222222222100000000000000000000000000000000000
12222222222222222222222222222222222222222222222222222222222222222222222222222222222222222222100000000000000000000000000000000000
12222222222222222200000000000000000000000000000000000000000000000000002222222222222222222222100000000000000000000000000000000000
12222222222222200000000000000000000000000000000000000000000000000000000002222222222222222222100000000000000000000000000000000000
12222222222220000000000000000000000000000000000000000000000000000000000000022222222222222222100000000000000000000000000000000000
12222222222000000000000000000000000000000000000000000000000000000000000000000222222222222222100000000000000000000000000000000000
12222222220000000000000000000000000000000000000000000000000000000000000000000022222222222222100000000000000000000000000000000000
12222222200000000000000000000000000000000000000000000000000000000000000000000002222222222222100000000000000000000000000000000000
12222222000000000000000000000000000000000000000000000000000000000000000000000002222222222222100000000000000000000000000000000000
12222222000000000000000000000000000000000000000000000000000000000000000000000000222222222222100000000000000000000000000000000000
12222220000000000000000000000000000000000000000000000000000000000000000000000000222222222222100000000000000000000000000000000000
12222220000000000000000000000000000000000000000000000000000000000000000000000000022222222222100000000000000000000000000000000000
12222200000000000000000000002222222222222222222222222222220000000000000000000000022222222222100000000000000000000000000000000000
12222200000000000000022222222222222222222222222222222222222222222200000000000000022222222222100000000000000000000000000000000000
12222200000000000002222222222222222222222222222222222222222222222222000000000000002222222222100000000000000000000000000000000000
12222000000000000022222222222222222222222222222222222222222222222222200000000000002222222222100000000000000000000000000000000000
12222000000000000222222222222222222222222222222222222222222222222222220000000000002222222222100000000000000000000000000000000000
12222000000000000222222222222222222222222222222222222222222222222222220000000000002222222222100000000000000000000000000000000000
12222000000000002222222222222222222222222222222222222222222222222222222000000000002222222222100000000000000000000000000000000000
12222000000000002222222222222222222222222222222222222222222222222222222000000000002222222222100000000000000000000000000000000000
12222000000000002222222222222222222222222222222222222222222222222222222000000000002222222222100000000000000000000000000000000000
12222000000000002222222222222222222222222222222222222222222222222222222000000000002222222222111111111111111111111111111111111111
12222000000000022222222222222222222222222222222222222222222222222222222000000000002222222222222222222222222222222222222222222221
12222000000000022222222222222222222222222222222222222222222222222222222000000000002222222222222222222222222222222222222222222221
12222000000000022222222222222222222222222222222222222222222222222222222000000000000222222222222222222222222222222222222222222221
12222000000000022222222222222222222222222222222222222222222222222222222000000000000222222222222222222222222222222222222222222221
12222000000000022222222222222222222222222222222222222222222222222222222000000000000022222222222222222222222222222222222222222221
12222000000000022222222222222222222222222222222222222222222222222222222000000000000000000002222222222222222222222222222222222221
12222000000000022222222222222222222222222222222222222222222222222222222000000000000000000000000000000000000222222222222222222221
12222000000000022222222222222222222222222222222222222222222222222222222000000000000000000000000000000000000000222222222222222221
12222000000000022222222222222222222222222222222222222222222222222222222200000000000000000000000000000000000000002222222222222221
12222000000000022222222222222222222222222222222222222222222222222222222200000000000000000000000000000000000000000022222222222221
12222000000000022222222222222222222222222222222222222222222222222222222200000000000000000000000000000000000000000002222222222221
12222000000000022222222222222222222222222222222222222222222222222222222220000000000000000000000000000000000000000000222222222221
12222000000000022222222222222222222222222222222222222222222222222222222220000000000000000000000000000000000000000000022222222221
12222000000000022222222222222222222222222222222222222222222222222222222222000000000000000000000000000000000000000000022222222221
12222000000000022222222222222222222222222222222222222222222222222222222222220000000000000000000000000000000000000000002222222221
12222000000000022222222222222222222222222222222222222222222222222222222222222220000000000000000000000000000000000000002222222221
12222000000000022222222222222222222222222222222222222222222222222222222222222222222222222222222200000000000000000000000222222221
12222000000000022222222222222222222222222222222222222222222222222222222222222222222222222222222222222222000000000000000222222221
12222000000000022222222222222222222222222222222222222222222222222222222222222222222222222222222222222222220000000000000222222221
12222000000000022221111111111111111111111111111111111111111111111111111111111111111111111111111112222222222000770000000022222221
12222000000000022221000000000000000000000000000000000000000000000000000000000000000000000000000012222222222200000000000022222221
12222000000000022221000000000000000000000000000000000000000000000000000000000000000000000000000012222222222200000000000022222221
12222000000000022221111111111111111111111111111111111111111111111111111111111111111111110000000012222222222220000000000022222221
12222000000000022222222222222222222222222222222222222222222222222222222222222222222222210000000012222222222220000000000022222221
12222000000000022222222222222222222222222222222222222222222222222222222222222222222222210000000012222222222220000000000022222221
12222000000000022222222222222222222222222222222222222222222200000000002222222222222222210000000012222222222220000000000022222221
12222000000000022222222222222222222222222222222222222222000000000000000002222222222222210000000012222222222222000000000022222221
12222000000000022222222222222222222222222222222222222000000000000000000000022222222222210000000012222222222222000000000022222221
12222000000000022222222222222222222222222222222222200000000000000000000000000222222222210000000012222222222222000000000022222221
12222000000000022222222222222222222222222222222220000000000000000000000000000022222222210000000012222222222222000000000022222221
12222000000000022222222222222222222222222222222000000000000000000000000000000002222222210000000012222222222222000000000022222221
12222000000000002222222222222222222222222222200000000000000000000000000000000002222222210000000012222222222222000000000022222221
12222000000000002222222222222222222222222220000000000000000000000000000000000000222222210000000012222222222222000000000022222221
12222000000000000222222222222222222222222000000000000000000000000000000000000000222222210000000012222222222222000000000022222221
12222000000000000022222222222222222222200000000000000000000000000000000000000000022222210000000012222222222222000000000022222221
12222000000000000000222222222222222200000000000000000000000000000000000000000000022222210000000012222222222222000000000022222221
12222000000000000000000000000000000000000000000000000000002222222222220000000000022222210000000012222222222222000000000022222221
12222200000000000000000000000000000000000000000000000000222222222222222000000000002222210000000012222222222222000000000022222221
12222200000000000000000000000000000000000000000000000022222222222222222000000000002222210000000012222222222222000000000022222221
12222200000000000000000000000000000000000000000000022222211111111112222200000000002222210000000012222222222222000000000022222221
12222220000000000000000000000000000000000000000002222222210000000012222200000000002222210000000012222222222222000000000022222221
12222220000000000000000000000000000000000000000222222222210000000012222200000000002222210000000012222222222222000000000022222221
12222222000000000000000000000000000000000000022222222222210000000012222200000000002222210000000012222222222222000000000022222221
12222222000000000000000000000000000000000002222222222222210000000012222200000000002222210000000012222222222222000000000022222221
12222222200000000000000000000000000000002222222222222222210000000012222200000000002222210000000012222222222222000000000022222221
12222222222000000000000000000000000022222222222222222222210000000012222200000000002222210000000012222222222222000000000022222221
12222222222220000000000000000000222222222222222222222222210000000012222200000000002222210000000012222222222222000000000022222221
12222222222222220000000000002222222222222222222222222222210000000012222200000000002222210000000012222222222222000000000022222221
12222222222222222222222222222222222222222222222222222222210000000012222200000000002222210000000012222222222222000000000022222221
12222222222222222222222222222222222222222222222222222222210000000012222200000000002222210000000012222222222220000000000022222221
11111111111111111111111111111111111111111111111111111111110000000012222200000000002222210000000012222222222220000000000022222221
00000000000000000000000000000000000000000000000000000000000000000012222200000000002222210000000012222222222220000000000022222221
00000000000000000000000000000000000000000000000000000000000000000012222200000000002222214444444412222222222220000000000022222221
11111111111111111111111111111111111111111111111111111111111111111111111100000000001111111111111112222222222200000000000022222221
12222222222222222222222222222222222222222222222222222222222222222222222100000000001222222222222222222222222200000000000022222221
12222222222222222222222222222222222222222222222222222222222222222222222100000000001222222222222222222222222000000000000022222221
12222222222222222222222222222222222222222222222222222222222222222222222100000000001222222222222222222222200000000000000022222221
12222222222222222222222222220000000000000000002222222222222222220000000100000000001222222222222220000000000000000000000222222221
12222222222222222222222200000000000000000000000000000000000000000000044100000000001:22000000000000000000000000000000000222222221
12222222222222222222220000000000000000000000000000000000000000000000044100000000001:22000000000000000000000000000000000222222221
12222222222222222222200000000000000000000000000000000000000000000000044100000000001:20000000000000000000000000000000002222222221
12222222222222222222000000000000000000000000000000000000000000000000044100000000001:20000000000000000000000000000000002222222221
12222222222222222220000000000000000000000000000000000000000000000000044100000000001:00000000000000000000000000000000022222222221
12222222222222222200000000000000000000000000000000000000000000000000044100000000001:22200000000000000000000000000000222222222221
12222222222222222000000000000000000000000000000000000000000000000000044100000000001:22200000000000000000000000000022222222222221
12222222222222220000000000000000000000000000000000000000000000000000044100000000001:22200000000000000000000000002222222222222221
12222222222222200000000000000000000000000000000000000000000000000000044100000000001:22220000000000000000000002222222222222222221
12222222222222000000000000000000000000000000000000000000000000000000044100000000001:22220000000000000000022222222222222222222221
12222222222220000000000000000000000022222222222222222222222222220000000100000000001222222222222222222222222222222222222222222221
12222222222200000000000000000002222222222222222222222222222222222222222100000000001222222222222222222222222222222222222222222221
12222222222000000000000000000222222222222222222222222222222222222222222100000000001222222222222222222222222222222222222222222221
12222222220000000000000000002222222222222222222222222222222222222222222100000000001222222222222222222222222222222222222222222221
12222222200000000000000000022221111111111111111111111111111111111111111100000000001111111111111111111111111111111111111111111111
12222222200000000000000000222221000000000000000000000000000000000012222200000000002222210000000000000000000000000000000000000000
12222222000000000000000002222111000000000000000000000000000000000012222200000000002222210000000000000000000000000000000000000000
12222222000000000000000022222100000000000000000000000000000000000012222200000000002222210000000000000000000000000000000000000000
12222220000000000000000222211100011111111111111111111111111111111112222200000000002222210000000000000000000000000000000000000000
12222220000000000000002222210000012222222222222222222222222222222222222000000000002222210000000000000000000000000000000000000000
12222220000000000000022221110111112222222222222222222222222222222222222000000000002222210000000000000000000000000000000000000000
12222200000000000000022111000122222222222222222222222222222222222222220000000000002222210000000000000000000000000000000000000000
12222200000000000000222100011122222222222222222222222222222222220000000000000000002222210000000000000000000000000000000000000000
12222200000000000000022111112222222200000000000000000000000000000000000000000000022222210000000000000000000000000000000000000000
12222200000000000000022222222222000000000000000000000000000000000000000000000000022222210000000000000000000000000000000000000000
12222200000000000000000000000000000000000000000000000000000000000000000000000000022222210000000000000000000000000000000000000000
12222200000000000000000000000000000000000000000000000000000000000000000000000000222222210000000000000000000000000000000000000000
12222200000000000000000000000000000000000000000000000000000000000000000000000000222222210000000000000000000000000000000000000000
12222200000000000000000000000000000000000000000000000000000000000000000000000002222222210000000000000000000000000000000000000000
12222220000000000000000000000000000000000000000000000000000000000000000000000002222222210000000000000000000000000000000000000000
12222220000000000000000000000000000000000000000000000000000000000000000000000022222222210000000000000000000000000000000000000000
12222220000000000000000000000000000000000000000000000000000000000000000000000222222222210000000000000000000000000000000000000000
12222222000000000000000000000000000000000000000000000000000000000000000000022222222222210000000000000000000000000000000000000000
12222222000000000000000000000000000000000000000000000000000000000000000002222222222222210000000000000000000000000000000000000000
12222222200000000000000000000000000000000000000000000000000000000000002222222222222222210000000000000000000000000000000000000000
12222222200000000000000000000000000000000000000000002222222222222222222222222222222222210000000000000000000000000000000000000000
12222222222000000000000000000000000000022222222222222222222222222222222222222222222222210000000000000000000000000000000000000000
12222222222220000000000000000000000222222222222222222222222222222222222222222222222222210000000000000000000000000000000000000000
12222222222222220000000000000222222222222222222222222222222222222222222222222222222222210000000000000000000000000000000000000000
12222222222222222222222222222222222222222222222222222222222222222222222222222222222222210000000000000000000000000000000000000000
12222222222222222222222222222222222222222222222222222222222222222222222222222222222222210000000000000000000000000000000000000000
12222222222222222222222222222222222222222222222222222222222222222222222222222222222222210000000000000000000000000000000000000000
12222222222222222222222222222222222222222222222222222222222222222222222222222222222222210000000000000000000000000000000000000000
12222222222222222222222222222222222222222222222222222222222222222222222222222222222222210000000000000000000000000000000000000000
11111111111111111111111111111111111111111111111111111111111111111111111111111111111111110000000000000000000000000000000000000000
